部屋	へや
書く	かく
帰る	かえ（る）
空いてます	あいてます
次	つぎ
明日	あさ
払う	はらう
町	まち
一番	いちばん
高い	たかい
決める	きめる
日程	にってい
約束	やくそく
友達	ともだち
乗る	のる
学校	がっこう
教える	おしえる
祖父	そふ
娘	むすめ
今	いま
足	あし
客様	きゃくさま
建てる	たてる
仕事	しごと
忙しい	いそがしい
笑う	わらう
色	いろ
足りない	たりない
楽しい	たのしい
平仮名	ひらがな
短い	みじかい
全部	ぜんぶ
勉強	べんきょ
続く	つづく
勝つ	かつ
置く	おく
言葉	ことば
息子	むすこ
雑誌	ざっし
手紙	てがみ
会社	かいしゃ
疲れる	つかれる
戻ります	もどります
数	かず
