別	べつ
終わる	おわる
送る	おくる
彼女	かのじょ
大好き	だいすき
猿	さる
落ちる	おちる
狭い	せまい
着る	きる
夫	おっと
胸	むね
痛む	いたむ
週	しゅう
達人	たつじん
飛行機	ひこうき
読む	よむ
誰	だれ
話し	はなし
知らない	しらない
結婚	けっこん
美しい	うつくしい
絵	え
忘れない	わすれない
犬	いぬ
病気	びょうき
低い	ひくい
取る	とる
新しい	あたらしい
駅	えき
歩く	あるく
難しい	むずかしい
覚える	おぼえる
午前	ごぜん
午後	ごご
年	とし
長い	ながい
思う	おもう
旅行	りょこう
変えました	かえました
生きる	いきる
冬	ふゆ
夏	なつ
春	はる
秋	あき
姉	あね
妹	いもと
銀行	ぎんこう
働く	はたらく
学生	がくせい
早い	はやい
時間	じかん
食事	しょくじ
近く	ちかく
彼	かれ
医者	いしゃ
上司	じょうし
一杯	いっぱい
飲もう	のもう
